1111111111111
1P000C0000001
1000011110001
1000000010001
1011101110001
100000001C001
1W00111111011
1000000000001
1E11111111111
1111111111111