1111111111111
1P0100000C001
11000111000E1
1111111111111