1111111111111
1P00000000C01
1100011110001
1010000000001
1000011111101
10010000000C1
1E11111111111
1111111111111