1111111111111111111111111111111111
1E0000000000000C00000C000000000001
10100101001W0000101001000000010101
1010010010101010001001000000001011
1P0000000C00C000000000W00000000001
1111111111111111111111111111111111